NO textures/north.xpm

SO textures/south.xpm

WE textures/west.xpm

EA textures/east.xpm

F 118,118,118

C 184,234,255


111111111111111111111111111111111111111111111111111111
11110000000000000100000000000000000W000000000000000001
11111000000000001000000010000000000000000000000000001
111111111111100001000000000000000111111111111111111111
111111111111111001000000000000000111111
111111111111111000000000000000000000111
110000000000000000000000000000000000111
111111111111111111111111000111111111111
111111111111111111111111000111111111111
111111111111111111111111000111111111111
111111111111111111111111000111111111111
111111110000000000000000000111111111111
111111110000000000000000000000111111111
111111111111111111111111000111111111111
111111111111111111111111111111111111111