NO textures/north.xpm

SO textures/south.xpm

EA textures/east.xpm

WE textures/west.xpm

F 110,124,133

C 110,190,216

1111111111111111111111111111
1000000000000D00000000000001
1000000000000100000000000001
111111D111111100000000000001
1010000000010000000000000001
10D000W0000D0000000000000001
1010000000010000000000000001
10101D1000010000000000000001
1111111111111111111111111111
