NO textures/north.xpm

SO textures/south.xpm

EA textures/east.xpm

WE textures/west.xpm

F 110,124,133

C 110,190,216

1111111111111111111
1000000000000000001
1000000000000000001
111111001D100111111
1000000000000000001
10000000W0000000001
1111111111111111111
