NO  textures/north.xpm

SO textures/south.xpm
F 118,118,118

WE textures/west.xpm



C 184,234,388

EA textures/east.xpm

111111111111111
111111111111111
100000000000001
100000000000001
100000000000001
100000000S00001
100000000000001
111111111111111
