NO textures/north.xpm
F 110,124,133

C 110,190,216

SO textures/south.xpm

EA textures/east.xpm

WE textures/west.xpm

     

11111111111111111111111111111111111111111
10111111111111111111111111111000000000111
10000000001000000000000000001000000000111
100000000010000000W0000000001000000000111
1000000000D00000000000000000D000000000111
10000000001000000000000000001000000000111
111111111111111111D1111111111111111111111
10000000000000000000000000000000000000111
10000000000000000000000000000000000000111
10000000000000000000000000000000000000111
11111111111111111111111111111111111111111
