NO textures/north.xpm
SO textures/south.xpm
EA textures/east.xpm
WE textures/west.xpm

F 97,96,94

C 110,190,216

111111111111111111111111111111111111111111111111111111111111111111111
101111111111111111111111111110000000000000000000000000000000000000111
1000000000100000000000000000D000000000111111111111D1111111111111111
1000000000100000000000000011100000001111111100000000001
1000000000D00000000000000000D00000000011111110000000001
1000000000100000000000000000100000000011100000000000001
1111111111111111111D11111111111111111111100000000000001
10000000000000010000000100000000000000D0000000000000001
1000000000000001110001110000000000000011100000000000001
1000000000000001111D111100000000000000111000000000000E1
100000000000000100000001000000000000001111111111111111
11111111111111111111111111111111111111111
