NO textures/north.xpm

SO textures/south.xpm

EA textures/east.xpm

WE textures/west.xpm

F 110,124,133

C 110,190,216

11111111111111111111111111111111
10000000000001000000000000000001
100000000000011111111D1111111111
1000000000000D000000000000000001
10000000000001000000000000000001
1000000000000100000000E000000001
10000000000001000000000000000001
111111D1111111000000000000000001
10000000000001000000000000000001
1000000000000D000000000000000001
10000000000001000000000000000001
10000000000001000000000000000001
11111111111111111111111111111111
