NO textures/north.xpm

SO textures/south.xpm

WE textures/west.xpm

EA textures/east.xpm

F 84,147,84

C 184,234,255










11111111111111
100000000000001
1111100000W001
111111111111101
111111111111111