NO  textures/north.xpm

SO textures/south.xpm

EA textures/east.xpm

WE textures/west.xpm

F 110,124,133


C 110,190,216

111111111111111
111111111111111
100000000000001
100000100000001
100000010000001
100000000N00001
100000000000001
111111111111111
