C 110,190,216
NO textures/north.xpm
SO textures/south.xpm
EA textures/east.xpm
WE textures/west.xpm

F 110,8,80


1111
1WD1
111