NO textures/north.xpm

SO textures/south.xpm

EA textures/east.xpm

WE textures/west.xpm

F 110,124,133

C 110,190,216
                       

11111111111111111111111111111111111111111
10111111111111111111111111111000000000111
10000000000000000000000000000000000000111
100000000000000000W0000000000000000000111
10000000000000000000000000000000000000111
10000000000000000000000000000000000000111
111111111111111111D1111111111111111111111
10000000000000000000000000000000000000111
10000000000000000000000000000000000000111
10000000000000000000000000000000000000111
11111111111111111111111111111111111111111

