NO textures/north.xpm

SO textures/south.xpm

WE textures/west.xpm

EA textures/east.xpm

F 220,100,0

C 225,30,87



1111111111111111111111111111111111
10000000001100000000000000000000011
10110000011100000W00000000000000011
1001000000000000000000000000000011
1111111110110000011100000000000011
1000000000110000011101111111111111
11110111111111011100000010001
11110111111111011101010010001
110000001101010111000000010001
10000000000000001100000010001
1000000000000001101010010001
11000001110101011111011110111
11110111 1110101 10111110001
11111111 1111111 1111111111