



NO texture/north_texture


SO texture/south_texture




WE texture/west_texture





EA texture/east_texture

F 220,100,0


C 225,30,87




1111111111111111111111111111111111
1000000000110000000000000000000001
1011000001110000000000000000000001
100100000000000000000000000000001
111111111011000001110000000000001
100000000011000001110111111111111
11110111111111011100000010001
11110111111111011101010010001
110000001101010111000000010001
10000000000000001100000010001
1000000000000001101010010001
11000001110101011111011110111
11110111 1110101 10111110W01
11111111 1111111 1111111111