NO textures/north.xpm
SO textures/south.xpm
EA textures/east.xpm
WE textures/west.xpm

F 110,124,133
C 110,190,216

11111111111111111111111111111111111111111
10111111111111111111111111111000000000111
10000000001E00000000000000001000000000111
1000000000100000000000000011100000001111
1000000000D00000000000000000D000000000111
10000000001000000000000000001000000000111
1111111111111111111D111111111111111111111
10000000000000010000000100000000000000111
10000000000000011100011100000000000000111
1000000000000001111D111100000000000000111
10000000000000010000000100000000000000111
11111111111111111111111111111111111111111
