NO texture/north_texture
SO texture/south_texture
WE texture/west_texture
EA texture/east_texture
F 220,100,0
C 225,30,87
     11111
1111111111
111111
1111111111