NO textures/north.xpm

SO textures/south.xpm

WE textures/west.xpm

EA textures/east.xpm

F 84,147,84

C 184,234,255


111111111111111111
111000000000000011
11100001D100100011
111000000000100011
111000000000D00011
11100000W000100011
111111111111111111
