F 20,100,0
NO texture/north_texture
SO texture/south_texture
WE texture/west_texture
EA texture/east_texture
C 225,30,8
1111111
110001111
111111101
       11111111
               1
    1           11
   1W1
    1            1