NO textures/north.xpm

SO textures/south.xpm

WE textures/west.xpm

EA textures/east.xpm

F 220,100,0

C 225,30,87



111111111111111111111
100000000000000000001
100000000000000000001
100000000000000000001
100000000000000000001
1000000000W0000000001
100000000000000000001
100000000000000000001
10000010000000000001
100000000000000000001
100000000000000000001
100000000000000000001
100000000000000000011
111111111111111111111